..................
..M...............
.............M....
......M...........
....ML............
.....M............
..M........M......
..................
