.........................................
.........................................
....#####................................
...#.....#...............................
...#......#..............................
....#.....#..............................
.....##.##........#####..................
.......#.........#.....#.................
..................#.....#................
...................#....#................
....................#####................
...........###...........................
..........#...#..........................
..........#...#..........................
...........###...........................
.........................................
.........................................
