.........................................
.........................................
.......#######...........................
....###.......#..........................
...#...........#.........................
...#..........#..........................
....#...######...........................
.....###.................................
.......................................##
......................................#..
...................................###...
..................................#......
..................................#......
...................................###...
......................................###
.........................................
.........................................
