11111111111111111111
10000000000000000001
10111111111111111101
10100101011000000101
10100000000000000101
10100000011000000101
10000000011000000101
10111111111111101101
10100000011000000101
10100000011000000101
10100000000000000101
10100000011000000101
10111110111111111101
10000000000000000001
11111111111111111111
